NO /home/amaligno/Projects/cub3d/textures/cat_32.xpm
SO /home/amaligno/Projects/cub3d/textures/funny_me.xpm
EA     /home/amaligno/Projects/cub3d/textures/mario.xpm
WE  /home/amaligno/Projects/cub3d/textures/funny.xpm
F 3,173,252
C 78,252,3


1111
11E0111
1111   
1111   