NO
WE








EA
SO

F
C

11111