NO ./textures/cat_32.xpm
SO ./textures/eyefloor.xpm
EA ./textures/mario.xpm
WE ./textures/funny.xpm
F 00,22,25
C 100,29,122


11111111
1000001
1000N001    1111
100001      1111
1000001
11111111