NO ./textures/cat_32.xpm
SO ./textures/eyefloor.xpm
EA ./textures/mario.xpm
WE ./textures/funny.xpm
F 00,22,25
C 100,29,122


1111111111111
1000001000001
1000011000011
10000111E0001
1000000000001
1111111111111