NO ./
SO ./
EA 
WE
F
C

111111111111111
10000000000001
10000000001111
110000000001111
 111111111111
