NO ./textures/N.xpm
SO ./textures/S.xpm
EA ./textures/E.xpm
WE ./textures/W.xpm
F 00,22,25
C 100,29,122


11111111
10010001
10000001
11000001
10000001
10N00111
10000001
11111111