NO ./textures/cobblestone.xpm
SO ./textures/dirt.xpm
EA ./textures/mossy_chiseled.xpm
WE ./textures/rock.xpm

F 120,68,28
C 35,51,56

11111
1S001
10001
10001            
10001
11111
