NO /home/amaligno/Projects/cub3d/textures/cat_32.xpm
SO /home/amaligno/Projects/cub3d/textures/funny_me.xpm
EA /home/amaligno/Projects/cub3d/textures/mario.xpm
WE /home/amaligno/Projects/cub3d/textures/me_logo.xpm

F 3,173,252
C 78,252,3

11111
1S001
10001
10001            
10001
11111
