NO ./textures/cobblestone.xpm
SO ./textures/dirt.xpm
EA ./textures/mossy_chiseled.xpm
WE ./textures/rock.xpm

F 120,68,28
C 35,51,56

1111111111111111111111
1S11100000000011111111
1011110111000000000001
1000000000000000010111            
1011111111111100110111
1000000100000010111111
1011110000110000111111
1111111111111111111111
